111111111111111111111111
10000000C000000000CC0001
1C0000000000000000000001
1000C0001000000000000001
111EC0000000000000000001
10000000000CC00000000001
10CC00000000000000111111
1000000C0000000000111111
1P00000111111100C0000001
111111111111111111111111
