1111111111
10000000C1
1C00000001
1000C00011
111EC00001
1000000001
10CC000001
1000000C01
1P00000001
1111111111
