1111111111
1000000011
1000000001
1000000011
111E100001
1000000001
1011000001
1000000101
1P00000001
1111111111
