1111111111
10100000C1
1C10000001
1010C00011
111EC00001
1000000001
10CC000001
1000000C01
1P00000001
1111111111
